▣▣▣▣▣▣▣▣▣▣▣▣▣
▣▣▣▣▣▣▣▣▣▣▣▣▣
▣▣▣▣▣▣▣▣▣▣▣▣▣
▣▣▣▣▣▣▣▣▣▣▣▣▣
▣▣▣▣▣▣▣▣▣▣▣▣▣
▣▣▣▣▣▣▣▣▣▣▣▣▣
▣▣▣▣▣▣▣▣▣▣▣▣▣
▣▣▣▣▣▣▣▣▣▣▣▣▣
▣▣▣▣▣▣▣▣▣▣▣▣▣
▣▣▣▣▣▣▣▣▣▣▣▣▣
▣▣▣▣▣▣▣▣▣▣▣▣▣
▣▣▣▣▣▣▣▣▣▣▣▣▣
▣▣▣▣▣▣▣▣▣▣▣▣▣
▣▣▣▣▣▣▣▣▣▣▣▣▣
▣▣▣▣▣▣▣▣▣▣▣▣▣
▣▣▣▣▣▣▣▣▣▣▣▣▣
▣▣▣▣▣▣▢▣▣▣▣▣▣
▣▣▣▣▣▣▢▣▣▣▣▣▣
▣▣▣▣▣▣▢▣▣▣▣▣▣
▣▣▣▣▣▣▢▣▣▣▣▣▣
▣▣▣▣▣▣▢▣▣▣▣▣▣
▣▣▣▣▣▣▢▣▣▣▣▣▣
▣▣▣▣▣▣▢▣▣▣▣▣▣
▣▣▣▣▣▣▢▣▣▣▣▣▣
▣▣▣▣▣▣▢▣▣▣▣▣▣
▣▣▣▢▢▢▢▣▣▣▣▣▣
▣▣▣▢▣▣▢▢▢▢▢▣▣
▣▣▣▢▣▣▢▣▣▣▢▣▣
▣▣▣▢▣▣▢▣▣▣▢▣▣
▣▣▣▢▣▣▢▣▣▣▢▣▣
▣▣▣▢▢▢▤▢▢▢▢▣▣
▣▣▣▣▣▣▢▣▣▣▣▣▣
▣▣▣▣▣▣▢▣▣▣▣▣▣
▣▣▣▣▣▣▢▣▣▣▣▣▣
▣▣▣▣▣▣▢▣▣▣▣▣▣
