▣▣▣▣▣▣▣▣▣▣▣▣▣▣▣▣▣▣▣▣▣▣▣▣▣▣▣
▣▣▣▣▣▣▣▣▣▣▣▣▣▣▣▣▣▣▣▣▣▣▣▣▣▣▣
▣▣▣▣▣▣▣▣▣▣▣▣▣▣▣▣▣▣▣▣▣▣▣▣▣▣▣
▣▣▣▣▣▣▣▣▣▣▣▣▣▣▣▣▣▣▣▣▣▣▣▣▣▣▣
▣▣▣▣▣▣▣▣▣▣▣▣▣▣▣▣▣▣▣▣▣▣▣▣▣▣▣
▣▣▣▣▣▣▣▣▣▣▣▣▣▣▣▣▣▣▣▣▣▣▣▣▣▣▣
▣▣▣▣▣▣▣▣▣▣▣▣▣▣▣▣▣▣▣▣▣▣▣▣▣▣▣
▣▣▣▣▣▣▣▣▣▣▣▣▣▣▣▣▣▣▣▣▣▣▣▣▣▣▣
▣▣▣▣▣▣▣▣▣▣▣▣▣▣▣▣▣▣▣▣▣▣▣▣▣▣▣
▣▣▣▣▣▣▣▣▣▣▣▣▣▣▣▣▣▣▣▣▣▣▣▣▣▣▣
▣▣▣▣▣▣▣▣▣▣▣▣▣▣▣▣▣▣▣▣▣▣▣▣▣▣▣
▣▣▣▣▣▣▣▣▣▣▣▣▣▣▣▣▣▣▣▣▣▣▣▣▣▣▣
▣▣▣▣▣▣▣▣▣▣▣▣▣▣▣▣▣▣▣▣▣▣▣▣▣▣▣
▣▣▣▣▣▣▣▣▣▣▣▣▣▣▣▣▣▣▣▣▣▣▣▣▣▣▣
▣▣▣▣▣▣▣▣▣▣▣▣▣▣▣▣▣▣▣▣▣▣▣▣▣▣▣
▣▣▣▣▣▣▣▣▣▣▣▣▣▣▣▣▣▣▣▣▣▣▣▣▣▣▣
▣▣▣▣▣▣▢▣▣▣▣▣▣▣▣▣▣▣▣▢▣▣▣▣▣▣▣
▣▣▣▣▣▣▢▣▣▣▣▣▣▣▣▣▣▣▣▢▣▣▣▣▣▣▣
▣▣▣▣▣▣▢▣▣▣▣▣▣▣▣▣▣▣▣▢▣▣▣▣▣▣▣
▣▣▣▣▣▣▢▣▣▣▣▣▣▣▣▣▣▣▣▢▣▣▣▣▣▣▣
▣▣▣▣▣▣▢▣▣▣▣▣▣▣▣▣▣▣▣▢▣▣▣▣▣▣▣
▣▣▣▣▣▣▢▣▣▣▣▣▣▣▣▣▣▣▣▢▣▣▣▣▣▣▣
▣▣▣▣▣▣▢▣▣▣▣▣▣▣▣▣▣▣▣▢▣▣▣▣▣▣▣
▣▣▣▣▣▣▢▣▣▣▣▣▣▣▣▣▣▣▣▢▣▣▣▣▣▣▣
▣▣▣▣▣▣▢▣▣▣▣▣▣▣▣▣▣▣▣▢▣▣▣▣▣▣▣
▣▣▣▢▢▢▢▣▣▣▣▣▣▣▣▣▢▢▢▢▣▣▣▣▣▣▣
▣▣▣▢▣▣▢▢▢▢▢▣▣▣▣▣▢▣▣▢▢▢▢▢▣▣▣
▣▣▣▢▣▣▢▣▣▣▢▣▣▣▣▣▢▣▣▢▣▣▣▢▣▣▣
▣▣▣▢▣▣▢▣▣▣▢▢▢▢▢▢▢▣▣▢▣▣▣▢▣▣▣
▣▣▣▢▣▣▢▣▣▣▢▣▣▢▣▣▢▣▣▢▣▣▣▢▣▣▣
▣▣▣▢▢▢▢▢▢▢▢▢▢▤▢▢▢▢▢▢▢▢▢▢▣▣▣
▣▣▣▣▣▣▢▣▣▣▣▣▣▢▣▣▣▣▣▢▣▣▣▣▣▣▣
▣▣▣▣▣▣▢▣▣▣▣▣▣▢▣▣▣▣▣▢▣▣▣▣▣▣▣
▣▣▣▣▣▣▢▢▢▢▢▢▢▢▢▢▢▢▢▣▣▣▣▣▣▣▣
▣▣▣▣▣▣▣▣▣▣▣▣▣▢▣▣▣▣▣▣▣▣▣▣▣▣▣
