▣▣▣▣▣▣▣▣▣▣▣▣▣▣▣▣▣▣▣▣▣▣▣▣▣▣▣
▣▣▣▣▣▣▣▣▣▣▣▣▣▣▣▣▣▣▣▣▣▣▣▣▣▣▣
▣▣▣▣▣▣▣▣▣▣▣▣▣▣▣▣▣▣▣▣▣▣▣▣▣▣▣
▣▣▣▣▣▣▣▣▣▣▣▣▣▣▣▣▣▣▣▣▣▣▣▣▣▣▣
▣▣▣▣▣▣▣▣▣▣▣▣▣▣▣▣▣▣▣▣▣▣▣▣▣▣▣
▣▣▣▣▣▣▢▣▣▣▣▣▣▣▣▣▣▣▣▢▣▣▣▣▣▣▣
▣▣▣▣▣▣▢▣▣▣▣▣▣▣▣▣▣▣▣▢▣▣▣▣▣▣▣
▣▣▣▣▣▣▢▣▣▣▣▣▣▣▣▣▣▣▣▢▣▣▣▣▣▣▣
▣▣▣▣▣▣▢▣▣▣▣▣▣▣▣▣▣▣▣▢▣▣▣▣▣▣▣
▣▣▣▣▣▣▢▣▣▣▣▣▣▣▣▣▣▣▣▢▣▣▣▣▣▣▣
▣▣▣▣▣▣▢▣▣▣▣▣▣▣▣▣▣▣▣▢▣▣▣▣▣▣▣
▣▣▣▣▣▣▢▣▣▣▣▣▣▣▣▣▣▣▣▢▣▣▣▣▣▣▣
▣▣▣▣▣▣▢▣▣▣▣▣▣▣▣▣▣▣▣▢▣▣▣▣▣▣▣
▣▣▣▣▣▣▢▣▣▣▣▣▣▣▣▣▣▣▣▢▣▣▣▣▣▣▣
▣▣▣▣▣▣▢▣▣▣▣▣▣▣▣▣▣▣▣▢▣▣▣▣▣▣▣
▣▣▣▢▢▢▢▣▣▣▣▣▣▣▣▣▢▢▢▢▣▣▣▣▣▣▣
▣▣▣▢▢▢▢▢▢▢▢▢▢▢▢▢▢▣▣▢▢▢▢▢▣▣▣
▣▣▣▣▣▣▢▣▣▣▣▣▣▣▣▣▣▣▣▢▣▣▣▢▣▣▣
▣▣▣▣▣▣▢▣▣▣▣▣▣▣▣▣▣▣▣▢▣▣▣▢▣▣▣
▣▣▣▣▣▣▢▣▣▣▣▣▣▣▣▣▣▣▣▢▣▣▣▢▣▣▣
▣▣▣▢▢▢▢▣▣▣▣▣▣▣▣▣▢▢▢▢▣▣▣▢▣▣▣
▣▣▣▢▢▢▢▢▢▢▢▢▢▢▢▢▢▣▣▢▢▢▢▢▣▣▣
▣▣▣▣▣▣▢▣▣▣▣▣▣▣▣▣▣▣▣▢▣▣▣▣▣▣▣
▣▣▣▣▣▣▢▣▣▣▣▣▣▣▣▣▣▣▣▢▣▣▣▣▣▣▣
▣▣▣▣▣▣▢▣▣▣▣▣▣▣▣▣▢▢▢▢▣▣▣▣▣▣▣
▣▣▣▣▣▣▢▢▢▢▢▢▢▢▢▢▢▣▣▢▢▢▢▢▣▣▣
▣▣▣▣▣▣▢▣▣▣▣▣▣▣▣▣▢▢▢▢▣▣▣▢▣▣▣
▣▣▣▢▢▢▢▢▢▢▢▣▣▣▣▣▢▣▣▢▢▢▢▢▣▣▣
▣▣▣▢▣▣▢▣▣▣▢▣▣▣▣▣▢▣▣▢▣▣▣▢▣▣▣
▣▣▣▢▣▣▢▣▣▣▢▢▢▢▢▢▢▣▣▢▣▣▣▢▣▣▣
▣▣▣▢▣▣▢▣▣▣▢▣▣▢▣▣▢▣▣▢▣▣▣▢▣▣▣
▣▣▣▢▢▢▢▢▢▢▢▢▢▤▢▢▢▢▢▢▢▢▢▢▣▣▣
▣▣▣▣▣▣▢▣▣▣▣▣▣▢▣▣▣▣▣▢▣▣▣▣▣▣▣
▣▣▣▣▣▣▢▣▣▣▣▣▣▢▣▣▣▣▣▢▣▣▣▣▣▣▣
▣▣▣▣▣▣▢▢▢▢▢▢▢▢▢▢▢▢▢▢▣▣▣▣▣▣▣
▣▣▣▣▣▣▣▣▣▣▣▣▣▢▣▣▣▣▣▣▣▣▣▣▣▣▣
